111111111111111
1P000C00000C0E1
101111011111101
1C0000110000001
101101011011111
1C0C000C00000C1
101111011101111
1C0000001000001
101011111110101
111111111111111