1111111111111111111111111
111P000001C00C00000000111
1110C11011001C00C11C11111
1110011111111011111110111
1110C00000000C00C00C00111
1110011111111111111110111
1110C00010000C00C11C00111
1110111110111100111110111
1110C00000C00000000C00111
1111001111111111111110111
1110C00000C00C00000C00111
1110001111011100111110111
1110C10001000C00010C00111
1110011101100111111100111
1110C00C00000000C00C00111
1111111100111111001110111
1110000000C00C00C00010111
111100111001010001111E111
1111111111111111111111111