1111111111
100P000001
1000C00001
100CEC0001
1000C00001
1000000001
1111111111