1111111111
10CPC00001
1111C11111
100C0C0001
100CEC0001
1000100001
1111111111