1111111111
1P0C0000E1
1011111101
1C00000C01
1010111101
1C0C000C01
1111111111