111111111111
111111111111
111C1P1E1111
111111111111