111111111111
1E0010000001
100100000C01
101000000001
1100000P0001
100C00000001
111111111111