1111111111111111111111
1111000000000000001111

100000000P0000E0000001
11111C0000011111111111
1111111111111111111111