111111111111
1P0000000001
1C0000000001
11110000CE01
111111111111