1111111111111
1100000P00111
111C000000111
1000000E00001
1111B00000001
1111111111111