11111111111111111111
11111111101011111111
111111110CEP01111111
11111111001000111111
11111111111111111111
