111111111111
111111111111
111CEP111111
111111111111