111111111111
111111111111
111CEP011111
111111111111