11111
1P0C1
10C01
1C0E0
11111
