111111
1P0C11
111011
1C0E11
111111